WEEK;DATE;TIME;HOME;AWAY;FTHG;FTAG;DIFF
1;16/08/2024;20:45;Le Havre;Paris S-G;1;4;-3
1;17/08/2024;17:00;Brest;Marseille;1;5;-4
1;17/08/2024;19:00;Reims;Lille;0;2;-2
1;17/08/2024;21:00;Monaco;Saint-Étienne;1;0;1
1;18/08/2024;15:00;Auxerre;Nice;2;1;1
1;18/08/2024;17:00;Angers;Lens;0;1;-1
1;18/08/2024;17:00;Toulouse;Nantes;0;0;0
1;18/08/2024;17:00;Montpellier;Strasbourg;1;1;0
1;18/08/2024;20:45;Rennes;Lyon;3;0;3
2;23/08/2024;20:45;Paris S-G;Montpellier;6;0;6
2;24/08/2024;17:00;Lyon;Monaco;0;2;-2
2;24/08/2024;19:00;Lille;Angers;2;0;2
2;24/08/2024;21:00;Saint-Étienne;Le Havre;0;2;-2
2;25/08/2024;15:00;Lens;Brest;2;0;2
2;25/08/2024;17:00;Nantes;Auxerre;2;0;2
2;25/08/2024;17:00;Nice;Toulouse;1;1;0
2;25/08/2024;17:00;Strasbourg;Rennes;3;1;2
2;25/08/2024;20:45;Marseille;Reims;2;2;0
3;30/08/2024;20:45;Lyon;Strasbourg;4;3;1
3;31/08/2024;17:00;Brest;Saint-Étienne;4;0;4
3;31/08/2024;19:00;Montpellier;Nantes;1;3;-2
3;31/08/2024;21:00;Toulouse;Marseille;1;3;-2
3;01/09/2024;15:00;Monaco;Lens;1;1;0
3;01/09/2024;17:00;Reims;Rennes;2;1;1
3;01/09/2024;17:00;Le Havre;Auxerre;3;1;2
3;01/09/2024;17:00;Angers;Nice;1;4;-3
3;01/09/2024;20:45;Lille;Paris S-G;1;3;-2
4;13/09/2024;20:45;Saint-Étienne;Lille;1;0;1
4;14/09/2024;17:00;Marseille;Nice;2;0;2
4;14/09/2024;19:00;Auxerre;Monaco;0;3;-3
4;14/09/2024;21:00;Paris S-G;Brest;3;1;2
4;15/09/2024;15:00;Rennes;Montpellier;3;0;3
4;15/09/2024;17:00;Nantes;Reims;1;2;-1
4;15/09/2024;17:00;Strasbourg;Angers;1;1;0
4;15/09/2024;17:00;Toulouse;Le Havre;2;0;2
4;15/09/2024;20:45;Lens;Lyon;0;0;0
5;20/09/2024;20:45;Nice;Saint-Étienne;8;0;8
5;21/09/2024;17:00;Lille;Strasbourg;3;3;0
5;21/09/2024;19:00;Rennes;Lens;1;1;0
5;21/09/2024;21:00;Reims;Paris S-G;1;1;0
5;22/09/2024;15:00;Monaco;Le Havre;3;1;2
5;22/09/2024;17:00;Brest;Toulouse;2;0;2
5;22/09/2024;17:00;Angers;Nantes;1;1;0
5;22/09/2024;17:00;Montpellier;Auxerre;3;2;1
5;22/09/2024;20:45;Lyon;Marseille;2;3;-1
6;27/09/2024;19:00;Auxerre;Brest;3;0;3
6;27/09/2024;21:00;Paris S-G;Rennes;3;1;2
6;28/09/2024;17:00;Lens;Nice;0;0;0
6;28/09/2024;19:00;Le Havre;Lille;0;3;-3
6;28/09/2024;21:00;Monaco;Montpellier;2;1;1
6;29/09/2024;15:00;Toulouse;Lyon;1;2;-1
6;29/09/2024;17:00;Nantes;Saint-Étienne;2;2;0
6;29/09/2024;17:00;Angers;Reims;1;3;-2
6;29/09/2024;20:45;Strasbourg;Marseille;1;0;1
7;04/10/2024;20:45;Marseille;Angers;1;1;0
7;05/10/2024;17:00;Saint-Étienne;Auxerre;3;1;2
7;05/10/2024;19:00;Lille;Toulouse;2;1;1
7;05/10/2024;21:00;Rennes;Monaco;1;2;-1
7;06/10/2024;15:00;Lyon;Nantes;2;0;2
7;06/10/2024;17:00;Brest;Le Havre;2;0;2
7;06/10/2024;17:00;Strasbourg;Lens;2;2;0
7;06/10/2024;17:00;Reims;Montpellier;4;2;2
7;06/10/2024;20:45;Nice;Paris S-G;1;1;0
8;18/10/2024;20:45;Monaco;Lille;0;0;0
8;19/10/2024;17:00;Brest;Rennes;1;1;0
8;19/10/2024;19:00;Saint-Étienne;Lens;0;2;-2
8;19/10/2024;21:00;Paris S-G;Strasbourg;4;2;2
8;20/10/2024;15:00;Le Havre;Lyon;0;4;-4
8;20/10/2024;17:00;Toulouse;Angers;1;1;0
8;20/10/2024;17:00;Auxerre;Reims;2;1;1
8;20/10/2024;17:00;Nantes;Nice;1;1;0
8;20/10/2024;20:45;Montpellier;Marseille;0;5;-5
9;25/10/2024;20:45;Rennes;Le Havre;1;0;1
9;26/10/2024;17:00;Angers;Saint-Étienne;4;2;2
9;26/10/2024;19:00;Reims;Brest;1;2;-1
9;26/10/2024;21:00;Lens;Lille;0;2;-2
9;27/10/2024;15:00;Lyon;Auxerre;2;2;0
9;27/10/2024;17:00;Montpellier;Toulouse;0;3;-3
9;27/10/2024;17:00;Nice;Monaco;2;1;1
9;27/10/2024;17:00;Strasbourg;Nantes;3;1;2
9;27/10/2024;20:45;Marseille;Paris S-G;0;3;-3
10;01/11/2024;19:00;Monaco;Angers;0;1;-1
10;01/11/2024;21:00;Lille;Lyon;1;1;0
10;02/11/2024;17:00;Paris S-G;Lens;1;0;1
10;02/11/2024;19:00;Brest;Nice;0;1;-1
10;02/11/2024;21:00;Saint-Étienne;Strasbourg;2;0;2
10;03/11/2024;15:00;Toulouse;Reims;1;0;1
10;03/11/2024;17:00;Le Havre;Montpellier;1;0;1
10;03/11/2024;17:00;Auxerre;Rennes;4;0;4
10;03/11/2024;20:45;Nantes;Marseille;1;2;-1
11;08/11/2024;20:45;Marseille;Auxerre;1;3;-2
11;09/11/2024;17:00;Strasbourg;Monaco;1;3;-2
11;09/11/2024;19:00;Lens;Nantes;3;2;1
11;09/11/2024;21:00;Angers;Paris S-G;2;4;-2
11;10/11/2024;15:00;Nice;Lille;2;2;0
11;10/11/2024;17:00;Rennes;Toulouse;0;2;-2
11;10/11/2024;17:00;Le Havre;Reims;0;3;-3
11;10/11/2024;17:00;Montpellier;Brest;3;1;2
11;10/11/2024;20:45;Lyon;Saint-Étienne;1;0;1
12;22/11/2024;19:00;Monaco;Brest;3;2;1
12;22/11/2024;21:00;Paris S-G;Toulouse;3;0;3
12;23/11/2024;17:00;Lens;Marseille;1;3;-2
12;23/11/2024;19:00;Saint-Étienne;Montpellier;1;0;1
12;23/11/2024;21:00;Reims;Lyon;1;1;0
12;24/11/2024;15:00;Lille;Rennes;1;0;1
12;24/11/2024;17:00;Auxerre;Angers;1;0;1
12;24/11/2024;17:00;Nantes;Le Havre;0;2;-2
12;24/11/2024;20:45;Nice;Strasbourg;2;1;1
13;29/11/2024;20:45;Reims;Lens;0;2;-2
13;30/11/2024;17:00;Rennes;Saint-Étienne;5;0;5
13;30/11/2024;19:00;Brest;Strasbourg;3;1;2
13;30/11/2024;21:00;Paris S-G;Nantes;1;1;0
13;01/12/2024;15:00;Montpellier;Lille;2;2;0
13;01/12/2024;17:00;Lyon;Nice;4;1;3
13;01/12/2024;17:00;Toulouse;Auxerre;2;0;2
13;01/12/2024;17:00;Le Havre;Angers;0;1;-1
13;01/12/2024;20:45;Marseille;Monaco;2;1;1
14;06/12/2024;19:00;Lille;Brest;3;1;2
14;06/12/2024;21:00;Auxerre;Paris S-G;0;0;0
14;07/12/2024;17:00;Monaco;Toulouse;2;0;2
14;07/12/2024;19:00;Nice;Le Havre;2;1;1
14;07/12/2024;21:00;Angers;Lyon;0;3;-3
14;08/12/2024;15:00;Lens;Montpellier;2;0;2
14;08/12/2024;17:00;Nantes;Rennes;1;0;1
14;08/12/2024;17:00;Strasbourg;Reims;0;0;0
14;08/12/2024;20:45;Saint-Étienne;Marseille;0;2;-2
15;13/12/2024;20:45;Toulouse;Saint-Étienne;2;1;1
15;14/12/2024;17:00;Marseille;Lille;1;1;0
15;14/12/2024;19:00;Auxerre;Lens;2;2;0
15;14/12/2024;21:00;Reims;Monaco;0;0;0
15;15/12/2024;15:00;Montpellier;Nice;2;2;0
15;15/12/2024;17:00;Rennes;Angers;2;0;2
15;15/12/2024;17:00;Le Havre;Strasbourg;0;3;-3
15;15/12/2024;17:00;Brest;Nantes;4;1;3
15;15/12/2024;20:45;Paris S-G;Lyon;3;1;2
16;18/12/2024;21:00;Monaco;Paris S-G;2;4;-2
16;03/01/2025;21:00;Nice;Rennes;3;2;1
16;04/01/2025;17:00;Saint-Étienne;Reims;3;1;2
16;04/01/2025;19:00;Lille;Nantes;1;1;0
16;04/01/2025;21:00;Lyon;Montpellier;1;0;1
16;05/01/2025;15:00;Strasbourg;Auxerre;3;1;2
16;05/01/2025;15:00;Angers;Brest;2;0;2
16;05/01/2025;15:00;Lens;Toulouse;0;1;-1
16;05/01/2025;20:45;Marseille;Le Havre;5;1;4
17;10/01/2025;19:00;Nantes;Monaco;2;2;0
17;10/01/2025;21:05;Auxerre;Lille;0;0;0
17;11/01/2025;17:00;Brest;Lyon;2;1;1
17;11/01/2025;19:00;Reims;Nice;2;4;-2
17;11/01/2025;21:05;Rennes;Marseille;1;2;-1
17;12/01/2025;15:00;Le Havre;Lens;1;2;-1
17;12/01/2025;17:15;Toulouse;Strasbourg;1;2;-1
17;12/01/2025;17:15;Montpellier;Angers;1;3;-2
17;12/01/2025;20:45;Paris S-G;Saint-Étienne;2;1;1
18;17/01/2025;19:00;Montpellier;Monaco;2;1;1
18;17/01/2025;21:05;Lille;Nice;2;1;1
18;18/01/2025;17:00;Lens;Paris S-G;1;2;-1
18;18/01/2025;19:00;Rennes;Brest;1;2;-1
18;18/01/2025;21:05;Lyon;Toulouse;0;0;0
18;19/01/2025;15:00;Saint-Étienne;Nantes;1;1;0
18;19/01/2025;17:15;Angers;Auxerre;2;0;2
18;19/01/2025;17:15;Reims;Le Havre;1;1;0
18;19/01/2025;20:45;Marseille;Strasbourg;1;1;0
19;24/01/2025;20:45;Auxerre;Saint-Étienne;1;1;0
19;25/01/2025;17:00;Monaco;Rennes;3;2;1
19;25/01/2025;19:00;Strasbourg;Lille;2;1;1
19;25/01/2025;21:05;Paris S-G;Reims;1;1;0
19;26/01/2025;15:00;Le Havre;Brest;0;1;-1
19;26/01/2025;17:15;Toulouse;Montpellier;1;2;-1
19;26/01/2025;17:15;Nantes;Lyon;1;1;0
19;26/01/2025;17:15;Lens;Angers;1;0;1
19;26/01/2025;20:45;Nice;Marseille;2;0;2
20;31/01/2025;20:45;Montpellier;Lens;0;2;-2
20;01/02/2025;17:00;Brest;Paris S-G;2;5;-3
20;01/02/2025;19:00;Monaco;Auxerre;4;2;2
20;01/02/2025;21:05;Lille;Saint-Étienne;4;1;3
20;02/02/2025;15:00;Toulouse;Nice;1;1;0
20;02/02/2025;17:15;Reims;Nantes;1;2;-1
20;02/02/2025;17:15;Rennes;Strasbourg;1;0;1
20;02/02/2025;17:15;Angers;Le Havre;1;1;0
20;02/02/2025;20:45;Marseille;Lyon;3;2;1
21;07/02/2025;19:00;Nantes;Brest;0;2;-2
21;07/02/2025;21:05;Paris S-G;Monaco;4;1;3
21;08/02/2025;17:00;Nice;Lens;2;0;2
21;08/02/2025;19:00;Lille;Le Havre;1;2;-1
21;08/02/2025;21:05;Saint-Étienne;Rennes;0;2;-2
21;09/02/2025;15:00;Lyon;Reims;4;0;4
21;09/02/2025;17:15;Strasbourg;Montpellier;2;0;2
21;09/02/2025;17:15;Auxerre;Toulouse;2;2;0
21;09/02/2025;20:45;Angers;Marseille;0;2;-2
22;14/02/2025;20:45;Brest;Auxerre;2;2;0
22;15/02/2025;17:00;Marseille;Saint-Étienne;5;1;4
22;15/02/2025;19:00;Monaco;Nantes;7;1;6
22;15/02/2025;21:05;Toulouse;Paris S-G;0;1;-1
22;16/02/2025;15:00;Montpellier;Lyon;1;4;-3
22;16/02/2025;17:15;Lens;Strasbourg;0;2;-2
22;16/02/2025;17:15;Reims;Angers;0;1;-1
22;16/02/2025;17:15;Le Havre;Nice;1;3;-2
22;16/02/2025;20:45;Rennes;Lille;0;2;-2
23;21/02/2025;20:45;Rennes;Reims;1;0;1
23;22/02/2025;17:00;Lille;Monaco;2;1;1
23;22/02/2025;19:00;Saint-Étienne;Angers;3;3;0
23;22/02/2025;21:05;Auxerre;Marseille;3;0;3
23;23/02/2025;15:00;Nantes;Lens;3;1;2
23;23/02/2025;17:15;Nice;Montpellier;2;0;2
23;23/02/2025;17:15;Le Havre;Toulouse;1;4;-3
23;23/02/2025;17:15;Strasbourg;Brest;0;0;0
23;23/02/2025;20:45;Lyon;Paris S-G;2;3;-1
24;28/02/2025;20:45;Monaco;Reims;3;0;3
24;01/03/2025;17:00;Saint-Étienne;Nice;1;3;-2
24;01/03/2025;19:00;Lens;Le Havre;3;4;-1
24;01/03/2025;21:05;Paris S-G;Lille;4;1;3
24;02/03/2025;15:00;Lyon;Brest;2;1;1
24;02/03/2025;17:15;Montpellier;Rennes;0;4;-4
24;02/03/2025;17:15;Auxerre;Strasbourg;0;1;-1
24;02/03/2025;17:15;Angers;Toulouse;0;4;-4
24;02/03/2025;20:45;Marseille;Nantes;2;0;2
25;07/03/2025;20:45;Toulouse;Monaco;1;1;0
25;08/03/2025;17:00;Rennes;Paris S-G;1;4;-3
25;08/03/2025;19:00;Lille;Montpellier;1;0;1
25;08/03/2025;21:05;Marseille;Lens;0;1;-1
25;09/03/2025;15:00;Brest;Angers;2;0;2
25;09/03/2025;17:15;Reims;Auxerre;0;2;-2
25;09/03/2025;17:15;Le Havre;Saint-Étienne;1;1;0
25;09/03/2025;17:15;Nantes;Strasbourg;0;1;-1
25;09/03/2025;20:45;Nice;Lyon;0;2;-2
26;14/03/2025;20:45;Nice;Auxerre;1;1;0
26;15/03/2025;17:00;Nantes;Lille;1;0;1
26;15/03/2025;19:00;Angers;Monaco;0;2;-2
26;15/03/2025;21:05;Lens;Rennes;1;0;1
26;16/03/2025;15:00;Lyon;Le Havre;4;2;2
26;16/03/2025;17:15;Strasbourg;Toulouse;2;1;1
26;16/03/2025;17:15;Montpellier;Saint-Étienne;0;2;-2
26;16/03/2025;17:15;Brest;Reims;0;0;0
26;16/03/2025;20:45;Paris S-G;Marseille;3;1;2
27;28/03/2025;20:45;Strasbourg;Lyon;4;2;2
27;29/03/2025;17:00;Reims;Marseille;3;1;2
27;29/03/2025;19:00;Saint-Étienne;Paris S-G;1;6;-5
27;29/03/2025;21:05;Monaco;Nice;2;1;1
27;30/03/2025;15:00;Toulouse;Brest;2;4;-2
27;30/03/2025;17:15;Le Havre;Nantes;3;2;1
27;30/03/2025;17:15;Auxerre;Montpellier;1;0;1
27;30/03/2025;17:15;Angers;Rennes;0;3;-3
27;30/03/2025;20:45;Lille;Lens;1;0;1
28;04/04/2025;20:45;Nice;Nantes;1;2;-1
28;05/04/2025;17:00;Paris S-G;Angers;1;0;1
28;05/04/2025;19:00;Brest;Monaco;2;1;1
28;05/04/2025;21:05;Lyon;Lille;2;1;1
28;06/04/2025;15:00;Lens;Saint-Étienne;1;0;1
28;06/04/2025;17:15;Rennes;Auxerre;0;1;-1
28;06/04/2025;17:15;Reims;Strasbourg;0;1;-1
28;06/04/2025;17:15;Montpellier;Le Havre;0;2;-2
28;06/04/2025;20:45;Marseille;Toulouse;3;2;1
29;11/04/2025;20:45;Lens;Reims;0;2;-2
29;12/04/2025;17:00;Monaco;Marseille;3;0;3
29;12/04/2025;19:00;Toulouse;Lille;1;2;-1
29;12/04/2025;21:05;Strasbourg;Nice;2;2;0
29;13/04/2025;15:00;Saint-Étienne;Brest;3;3;0
29;13/04/2025;17:15;Angers;Montpellier;2;0;2
29;13/04/2025;17:15;Le Havre;Rennes;1;5;-4
29;13/04/2025;20:45;Auxerre;Lyon;1;3;-2
30;18/04/2025;20:45;Rennes;Nantes;2;1;1
30;19/04/2025;17:00;Paris S-G;Le Havre;2;1;1
30;19/04/2025;19:00;Monaco;Strasbourg;0;0;0
30;19/04/2025;21:05;Marseille;Montpellier;5;1;4
30;20/04/2025;15:00;Lille;Auxerre;3;1;2
30;20/04/2025;17:15;Brest;Lens;1;3;-2
30;20/04/2025;17:15;Nice;Angers;2;1;1
30;20/04/2025;17:15;Reims;Toulouse;1;0;1
30;20/04/2025;20:45;Saint-Étienne;Lyon;2;1;1
29;22/04/2025;20:45;Nantes;Paris S-G;1;1;0
31;25/04/2025;20:45;Paris S-G;Nice;1;3;-2
31;26/04/2025;17:00;Strasbourg;Saint-Étienne;3;1;2
31;26/04/2025;19:00;Le Havre;Monaco;1;1;0
31;26/04/2025;21:05;Lyon;Rennes;4;1;3
31;27/04/2025;15:00;Angers;Lille;0;2;-2
31;27/04/2025;17:15;Nantes;Toulouse;0;0;0
31;27/04/2025;17:15;Lens;Auxerre;0;4;-4
31;27/04/2025;17:15;Montpellier;Reims;0;0;0
31;27/04/2025;20:45;Marseille;Brest;4;1;3
32;02/05/2025;20:45;Nice;Reims;1;0;1
32;03/05/2025;17:00;Strasbourg;Paris S-G;2;1;1
32;03/05/2025;19:00;Toulouse;Rennes;2;1;1
32;03/05/2025;21:05;Saint-Étienne;Monaco;1;3;-2
32;04/05/2025;15:00;Nantes;Angers;0;1;-1
32;04/05/2025;17:15;Brest;Montpellier;1;0;1
32;04/05/2025;17:15;Lyon;Lens;1;2;-1
32;04/05/2025;17:15;Auxerre;Le Havre;1;2;-1
32;04/05/2025;20:45;Lille;Marseille;1;1;0
33;10/05/2025;21:00;Reims;Saint-Étienne;0;2;-2
33;10/05/2025;21:00;Rennes;Nice;2;0;2
33;10/05/2025;21:00;Angers;Strasbourg;2;1;1
33;10/05/2025;21:00;Le Havre;Marseille;1;3;-2
33;10/05/2025;21:00;Auxerre;Nantes;1;1;0
33;10/05/2025;21:00;Monaco;Lyon;2;0;2
33;10/05/2025;21:00;Toulouse;Lens;1;1;0
33;10/05/2025;21:00;Montpellier;Paris S-G;1;4;-3
33;10/05/2025;21:00;Brest;Lille;2;0;2
34;17/05/2025;21:00;Lille;Reims;2;1;1
34;17/05/2025;21:00;Lens;Monaco;4;0;4
34;17/05/2025;21:00;Nantes;Montpellier;3;0;3
34;17/05/2025;21:00;Paris S-G;Auxerre;3;1;2
34;17/05/2025;21:00;Strasbourg;Le Havre;2;3;-1
34;17/05/2025;21:00;Lyon;Angers;2;0;2
34;17/05/2025;21:00;Nice;Brest;6;0;6
34;17/05/2025;21:00;Marseille;Rennes;4;2;2
34;17/05/2025;21:00;Saint-Étienne;Toulouse;2;3;-1