WEEK;DATE;TIME;HOME;AWAY;FTHG;FTAG;DIFF
1;23/08/2024;20:30;Gladbach;Leverkusen;2;3;-1
1;24/08/2024;15:30;Hoffenheim;Holstein Kiel;3;2;1
1;24/08/2024;15:30;Mainz 05;Union Berlin;1;1;0
1;24/08/2024;15:30;Augsburg;Werder Bremen;2;2;0
1;24/08/2024;15:30;Freiburg;Stuttgart;3;1;2
1;24/08/2024;15:30;RB Leipzig;Bochum;1;0;1
1;24/08/2024;18:30;Dortmund;Eint Frankfurt;2;0;2
1;25/08/2024;15:30;Wolfsburg;Bayern Munich;2;3;-1
1;25/08/2024;17:30;St. Pauli;Heidenheim;0;2;-2
2;30/08/2024;20:30;Union Berlin;St. Pauli;1;0;1
2;31/08/2024;15:30;Werder Bremen;Dortmund;0;0;0
2;31/08/2024;15:30;Eint Frankfurt;Hoffenheim;3;1;2
2;31/08/2024;15:30;Bochum;Gladbach;0;2;-2
2;31/08/2024;15:30;Holstein Kiel;Wolfsburg;0;2;-2
2;31/08/2024;15:30;Stuttgart;Mainz 05;3;3;0
2;31/08/2024;18:30;Leverkusen;RB Leipzig;2;3;-1
2;01/09/2024;15:30;Heidenheim;Augsburg;4;0;4
2;01/09/2024;17:30;Bayern Munich;Freiburg;2;0;2
3;13/09/2024;20:30;Dortmund;Heidenheim;4;2;2
3;14/09/2024;15:30;RB Leipzig;Union Berlin;0;0;0
3;14/09/2024;15:30;Gladbach;Stuttgart;1;3;-2
3;14/09/2024;15:30;Freiburg;Bochum;2;1;1
3;14/09/2024;15:30;Wolfsburg;Eint Frankfurt;1;2;-1
3;14/09/2024;15:30;Hoffenheim;Leverkusen;1;4;-3
3;14/09/2024;18:30;Holstein Kiel;Bayern Munich;1;6;-5
3;15/09/2024;15:30;Augsburg;St. Pauli;3;1;2
3;15/09/2024;17:30;Mainz 05;Werder Bremen;1;2;-1
4;20/09/2024;20:30;Augsburg;Mainz 05;2;3;-1
4;21/09/2024;15:30;Union Berlin;Hoffenheim;2;1;1
4;21/09/2024;15:30;Bochum;Holstein Kiel;2;2;0
4;21/09/2024;15:30;Heidenheim;Freiburg;0;3;-3
4;21/09/2024;15:30;Werder Bremen;Bayern Munich;0;5;-5
4;21/09/2024;18:30;Eint Frankfurt;Gladbach;2;0;2
4;22/09/2024;15:30;Leverkusen;Wolfsburg;4;3;1
4;22/09/2024;17:30;Stuttgart;Dortmund;5;1;4
4;22/09/2024;19:30;St. Pauli;RB Leipzig;0;0;0
5;27/09/2024;20:30;Dortmund;Bochum;4;2;2
5;28/09/2024;15:30;Mainz 05;Heidenheim;0;2;-2
5;28/09/2024;15:30;Freiburg;St. Pauli;0;3;-3
5;28/09/2024;15:30;RB Leipzig;Augsburg;4;0;4
5;28/09/2024;15:30;Gladbach;Union Berlin;1;0;1
5;28/09/2024;15:30;Wolfsburg;Stuttgart;2;2;0
5;28/09/2024;18:30;Bayern Munich;Leverkusen;1;1;0
5;29/09/2024;15:30;Holstein Kiel;Eint Frankfurt;2;4;-2
5;29/09/2024;17:30;Hoffenheim;Werder Bremen;3;4;-1
6;04/10/2024;20:30;Augsburg;Gladbach;2;1;1
6;05/10/2024;15:30;Bochum;Wolfsburg;1;3;-2
6;05/10/2024;15:30;Union Berlin;Dortmund;2;1;1
6;05/10/2024;15:30;Werder Bremen;Freiburg;0;1;-1
6;05/10/2024;15:30;Leverkusen;Holstein Kiel;2;2;0
6;05/10/2024;18:30;St. Pauli;Mainz 05;0;3;-3
6;06/10/2024;15:30;Heidenheim;RB Leipzig;0;1;-1
6;06/10/2024;17:30;Eint Frankfurt;Bayern Munich;3;3;0
6;06/10/2024;19:30;Stuttgart;Hoffenheim;1;1;0
7;18/10/2024;20:30;Dortmund;St. Pauli;2;1;1
7;19/10/2024;15:30;Leverkusen;Eint Frankfurt;2;1;1
7;19/10/2024;15:30;Mainz 05;RB Leipzig;0;2;-2
7;19/10/2024;15:30;Freiburg;Augsburg;3;1;2
7;19/10/2024;15:30;Hoffenheim;Bochum;3;1;2
7;19/10/2024;15:30;Gladbach;Heidenheim;3;2;1
7;19/10/2024;18:30;Bayern Munich;Stuttgart;4;0;4
7;20/10/2024;15:30;Holstein Kiel;Union Berlin;0;2;-2
7;20/10/2024;17:30;Wolfsburg;Werder Bremen;2;4;-2
8;25/10/2024;20:30;Mainz 05;Gladbach;1;1;0
8;26/10/2024;15:30;St. Pauli;Wolfsburg;0;0;0
8;26/10/2024;15:30;Stuttgart;Holstein Kiel;2;1;1
8;26/10/2024;15:30;Augsburg;Dortmund;2;1;1
8;26/10/2024;15:30;RB Leipzig;Freiburg;3;1;2
8;26/10/2024;18:30;Werder Bremen;Leverkusen;2;2;0
8;27/10/2024;15:30;Bochum;Bayern Munich;0;5;-5
8;27/10/2024;17:30;Union Berlin;Eint Frankfurt;1;1;0
8;27/10/2024;19:30;Heidenheim;Hoffenheim;0;0;0
9;01/11/2024;20:30;Leverkusen;Stuttgart;0;0;0
9;02/11/2024;15:30;Wolfsburg;Augsburg;1;1;0
9;02/11/2024;15:30;Bayern Munich;Union Berlin;3;0;3
9;02/11/2024;15:30;Eint Frankfurt;Bochum;7;2;5
9;02/11/2024;15:30;Holstein Kiel;Heidenheim;1;0;1
9;02/11/2024;15:30;Hoffenheim;St. Pauli;0;2;-2
9;02/11/2024;18:30;Dortmund;RB Leipzig;2;1;1
9;03/11/2024;15:30;Freiburg;Mainz 05;0;0;0
9;03/11/2024;17:30;Gladbach;Werder Bremen;4;1;3
10;08/11/2024;20:30;Union Berlin;Freiburg;0;0;0
10;09/11/2024;15:30;Bochum;Leverkusen;1;1;0
10;09/11/2024;15:30;Werder Bremen;Holstein Kiel;2;1;1
10;09/11/2024;15:30;Mainz 05;Dortmund;3;1;2
10;09/11/2024;15:30;St. Pauli;Bayern Munich;0;1;-1
10;09/11/2024;18:30;RB Leipzig;Gladbach;0;0;0
10;10/11/2024;15:30;Augsburg;Hoffenheim;0;0;0
10;10/11/2024;17:30;Stuttgart;Eint Frankfurt;2;3;-1
10;10/11/2024;19:30;Heidenheim;Wolfsburg;1;3;-2
11;22/11/2024;20:30;Bayern Munich;Augsburg;3;0;3
11;23/11/2024;15:30;Wolfsburg;Union Berlin;1;0;1
11;23/11/2024;15:30;Leverkusen;Heidenheim;5;2;3
11;23/11/2024;15:30;Hoffenheim;RB Leipzig;4;3;1
11;23/11/2024;15:30;Stuttgart;Bochum;2;0;2
11;23/11/2024;15:30;Dortmund;Freiburg;4;0;4
11;23/11/2024;18:30;Eint Frankfurt;Werder Bremen;1;0;1
11;24/11/2024;15:30;Holstein Kiel;Mainz 05;0;3;-3
11;24/11/2024;17:30;Gladbach;St. Pauli;2;0;2
12;29/11/2024;20:30;St. Pauli;Holstein Kiel;3;1;2
12;30/11/2024;15:30;RB Leipzig;Wolfsburg;1;5;-4
12;30/11/2024;15:30;Freiburg;Gladbach;3;1;2
12;30/11/2024;15:30;Union Berlin;Leverkusen;1;2;-1
12;30/11/2024;15:30;Werder Bremen;Stuttgart;2;2;0
12;30/11/2024;15:30;Augsburg;Bochum;1;0;1
12;30/11/2024;18:30;Dortmund;Bayern Munich;1;1;0
12;01/12/2024;15:30;Mainz 05;Hoffenheim;2;0;2
12;01/12/2024;17:30;Heidenheim;Eint Frankfurt;0;4;-4
13;06/12/2024;20:30;Stuttgart;Union Berlin;3;2;1
13;07/12/2024;15:30;Bochum;Werder Bremen;0;1;-1
13;07/12/2024;15:30;Holstein Kiel;RB Leipzig;0;2;-2
13;07/12/2024;15:30;Leverkusen;St. Pauli;2;1;1
13;07/12/2024;15:30;Eint Frankfurt;Augsburg;2;2;0
13;07/12/2024;15:30;Bayern Munich;Heidenheim;4;2;2
13;07/12/2024;18:30;Gladbach;Dortmund;1;1;0
13;08/12/2024;15:30;Wolfsburg;Mainz 05;4;3;1
13;08/12/2024;17:30;Hoffenheim;Freiburg;1;1;0
14;13/12/2024;20:30;Freiburg;Wolfsburg;3;2;1
14;14/12/2024;15:30;Augsburg;Leverkusen;0;2;-2
14;14/12/2024;15:30;Mainz 05;Bayern Munich;2;1;1
14;14/12/2024;15:30;Union Berlin;Bochum;0;2;-2
14;14/12/2024;15:30;Gladbach;Holstein Kiel;4;1;3
14;14/12/2024;18:30;St. Pauli;Werder Bremen;0;2;-2
14;15/12/2024;15:30;Heidenheim;Stuttgart;1;3;-2
14;15/12/2024;17:30;Dortmund;Hoffenheim;1;1;0
14;15/12/2024;19:30;RB Leipzig;Eint Frankfurt;2;1;1
15;20/12/2024;20:30;Bayern Munich;RB Leipzig;5;1;4
15;21/12/2024;15:30;Werder Bremen;Union Berlin;4;1;3
15;21/12/2024;15:30;Eint Frankfurt;Mainz 05;1;3;-2
15;21/12/2024;15:30;Stuttgart;St. Pauli;0;1;-1
15;21/12/2024;15:30;Hoffenheim;Gladbach;1;2;-1
15;21/12/2024;15:30;Holstein Kiel;Augsburg;5;1;4
15;21/12/2024;18:30;Leverkusen;Freiburg;5;1;4
15;22/12/2024;15:30;Bochum;Heidenheim;2;0;2
15;22/12/2024;17:30;Wolfsburg;Dortmund;1;3;-2
16;10/01/2025;20:45;Dortmund;Leverkusen;2;3;-1
16;11/01/2025;15:30;Mainz 05;Bochum;2;0;2
16;11/01/2025;15:30;St. Pauli;Eint Frankfurt;0;1;-1
16;11/01/2025;15:30;Heidenheim;Union Berlin;2;0;2
16;11/01/2025;15:30;Freiburg;Holstein Kiel;3;2;1
16;11/01/2025;15:30;Hoffenheim;Wolfsburg;0;1;-1
16;11/01/2025;18:30;Gladbach;Bayern Munich;0;1;-1
16;12/01/2025;15:30;RB Leipzig;Werder Bremen;4;2;2
16;12/01/2025;17:30;Augsburg;Stuttgart;0;1;-1
17;14/01/2025;18:30;Holstein Kiel;Dortmund;4;2;2
17;14/01/2025;20:30;Wolfsburg;Gladbach;5;1;4
17;14/01/2025;20:30;Leverkusen;Mainz 05;1;0;1
17;14/01/2025;20:30;Eint Frankfurt;Freiburg;4;1;3
17;15/01/2025;18:30;Bochum;St. Pauli;1;0;1
17;15/01/2025;20:30;Union Berlin;Augsburg;0;2;-2
17;15/01/2025;20:30;Stuttgart;RB Leipzig;2;1;1
17;15/01/2025;20:30;Werder Bremen;Heidenheim;3;3;0
17;15/01/2025;20:30;Bayern Munich;Hoffenheim;5;0;5
18;17/01/2025;20:30;Eint Frankfurt;Dortmund;2;0;2
18;18/01/2025;15:30;Holstein Kiel;Hoffenheim;1;3;-2
18;18/01/2025;15:30;Heidenheim;St. Pauli;0;2;-2
18;18/01/2025;15:30;Bochum;RB Leipzig;3;3;0
18;18/01/2025;15:30;Stuttgart;Freiburg;4;0;4
18;18/01/2025;15:30;Bayern Munich;Wolfsburg;3;2;1
18;18/01/2025;18:30;Leverkusen;Gladbach;3;1;2
18;19/01/2025;15:30;Union Berlin;Mainz 05;2;1;1
18;19/01/2025;17:30;Werder Bremen;Augsburg;0;2;-2
19;24/01/2025;20:30;Wolfsburg;Holstein Kiel;2;2;0
19;25/01/2025;15:30;Freiburg;Bayern Munich;1;2;-1
19;25/01/2025;15:30;RB Leipzig;Leverkusen;2;2;0
19;25/01/2025;15:30;Dortmund;Werder Bremen;2;2;0
19;25/01/2025;15:30;Augsburg;Heidenheim;2;1;1
19;25/01/2025;15:30;Mainz 05;Stuttgart;2;0;2
19;25/01/2025;18:30;Gladbach;Bochum;3;0;3
19;26/01/2025;15:30;Hoffenheim;Eint Frankfurt;2;2;0
19;26/01/2025;17:30;St. Pauli;Union Berlin;3;0;3
20;31/01/2025;20:30;Werder Bremen;Mainz 05;1;0;1
20;01/02/2025;15:30;Heidenheim;Dortmund;1;2;-1
20;01/02/2025;15:30;St. Pauli;Augsburg;1;1;0
20;01/02/2025;15:30;Bayern Munich;Holstein Kiel;4;3;1
20;01/02/2025;15:30;Bochum;Freiburg;0;1;-1
20;01/02/2025;15:30;Stuttgart;Gladbach;1;2;-1
20;01/02/2025;18:30;Union Berlin;RB Leipzig;0;0;0
20;02/02/2025;15:30;Eint Frankfurt;Wolfsburg;1;1;0
20;02/02/2025;17:30;Leverkusen;Hoffenheim;3;1;2
21;07/02/2025;20:30;Bayern Munich;Werder Bremen;3;0;3
21;08/02/2025;15:30;Freiburg;Heidenheim;1;0;1
21;08/02/2025;15:30;Dortmund;Stuttgart;1;2;-1
21;08/02/2025;15:30;Wolfsburg;Leverkusen;0;0;0
21;08/02/2025;15:30;Hoffenheim;Union Berlin;0;4;-4
21;08/02/2025;15:30;Mainz 05;Augsburg;0;0;0
21;08/02/2025;18:30;Gladbach;Eint Frankfurt;1;1;0
21;09/02/2025;15:30;Holstein Kiel;Bochum;2;2;0
21;09/02/2025;17:30;RB Leipzig;St. Pauli;2;0;2
22;14/02/2025;20:30;Augsburg;RB Leipzig;0;0;0
22;15/02/2025;15:30;Stuttgart;Wolfsburg;1;2;-1
22;15/02/2025;15:30;Union Berlin;Gladbach;1;2;-1
22;15/02/2025;15:30;St. Pauli;Freiburg;0;1;-1
22;15/02/2025;15:30;Bochum;Dortmund;2;0;2
22;15/02/2025;18:30;Leverkusen;Bayern Munich;0;0;0
22;16/02/2025;15:30;Werder Bremen;Hoffenheim;1;3;-2
22;16/02/2025;17:30;Eint Frankfurt;Holstein Kiel;3;1;2
22;16/02/2025;19:30;Heidenheim;Mainz 05;0;2;-2
23;21/02/2025;20:30;Freiburg;Werder Bremen;5;0;5
23;22/02/2025;15:30;Mainz 05;St. Pauli;2;0;2
23;22/02/2025;15:30;Wolfsburg;Bochum;1;1;0
23;22/02/2025;15:30;Gladbach;Augsburg;0;3;-3
23;22/02/2025;15:30;Holstein Kiel;Leverkusen;0;2;-2
23;22/02/2025;18:30;Dortmund;Union Berlin;6;0;6
23;23/02/2025;15:30;RB Leipzig;Heidenheim;2;2;0
23;23/02/2025;17:30;Bayern Munich;Eint Frankfurt;4;0;4
23;23/02/2025;19:30;Hoffenheim;Stuttgart;1;1;0
24;28/02/2025;20:30;Stuttgart;Bayern Munich;1;3;-2
24;01/03/2025;15:30;Werder Bremen;Wolfsburg;1;2;-1
24;01/03/2025;15:30;RB Leipzig;Mainz 05;1;2;-1
24;01/03/2025;15:30;Heidenheim;Gladbach;0;3;-3
24;01/03/2025;15:30;Bochum;Hoffenheim;0;1;-1
24;01/03/2025;15:30;St. Pauli;Dortmund;0;2;-2
24;01/03/2025;18:30;Eint Frankfurt;Leverkusen;1;4;-3
24;02/03/2025;15:30;Union Berlin;Holstein Kiel;0;1;-1
24;02/03/2025;17:30;Augsburg;Freiburg;0;0;0
25;07/03/2025;20:30;Gladbach;Mainz 05;1;3;-2
25;08/03/2025;15:30;Leverkusen;Werder Bremen;0;2;-2
25;08/03/2025;15:30;Bayern Munich;Bochum;2;3;-1
25;08/03/2025;15:30;Holstein Kiel;Stuttgart;2;2;0
25;08/03/2025;15:30;Wolfsburg;St. Pauli;1;1;0
25;08/03/2025;15:30;Dortmund;Augsburg;0;1;-1
25;08/03/2025;18:30;Freiburg;RB Leipzig;0;0;0
25;09/03/2025;15:30;Eint Frankfurt;Union Berlin;1;2;-1
25;09/03/2025;17:30;Hoffenheim;Heidenheim;1;1;0
26;14/03/2025;20:30;St. Pauli;Hoffenheim;1;0;1
26;15/03/2025;15:30;Union Berlin;Bayern Munich;1;1;0
26;15/03/2025;15:30;Werder Bremen;Gladbach;2;4;-2
26;15/03/2025;15:30;Mainz 05;Freiburg;2;2;0
26;15/03/2025;15:30;Augsburg;Wolfsburg;1;0;1
26;15/03/2025;18:30;RB Leipzig;Dortmund;2;0;2
26;16/03/2025;15:30;Bochum;Eint Frankfurt;1;3;-2
26;16/03/2025;17:30;Heidenheim;Holstein Kiel;3;1;2
26;16/03/2025;19:30;Stuttgart;Leverkusen;3;4;-1
27;28/03/2025;20:30;Leverkusen;Bochum;3;1;2
27;29/03/2025;15:30;Hoffenheim;Augsburg;1;1;0
27;29/03/2025;15:30;Holstein Kiel;Werder Bremen;0;3;-3
27;29/03/2025;15:30;Gladbach;RB Leipzig;1;0;1
27;29/03/2025;15:30;Bayern Munich;St. Pauli;3;2;1
27;29/03/2025;15:30;Wolfsburg;Heidenheim;0;1;-1
27;29/03/2025;18:30;Eint Frankfurt;Stuttgart;1;0;1
27;30/03/2025;15:30;Freiburg;Union Berlin;1;2;-1
27;30/03/2025;17:30;Dortmund;Mainz 05;3;1;2
28;04/04/2025;20:30;Augsburg;Bayern Munich;1;3;-2
28;05/04/2025;15:30;Mainz 05;Holstein Kiel;1;1;0
28;05/04/2025;15:30;RB Leipzig;Hoffenheim;3;1;2
28;05/04/2025;15:30;Freiburg;Dortmund;1;4;-3
28;05/04/2025;15:30;Bochum;Stuttgart;0;4;-4
28;05/04/2025;15:30;Heidenheim;Leverkusen;0;1;-1
28;05/04/2025;18:30;Werder Bremen;Eint Frankfurt;2;0;2
28;06/04/2025;15:30;St. Pauli;Gladbach;1;1;0
28;06/04/2025;17:30;Union Berlin;Wolfsburg;1;0;1
29;11/04/2025;20:30;Wolfsburg;RB Leipzig;2;3;-1
29;12/04/2025;15:30;Hoffenheim;Mainz 05;2;0;2
29;12/04/2025;15:30;Gladbach;Freiburg;1;2;-1
29;12/04/2025;15:30;Bochum;Augsburg;1;2;-1
29;12/04/2025;15:30;Leverkusen;Union Berlin;0;0;0
29;12/04/2025;15:30;Holstein Kiel;St. Pauli;1;2;-1
29;12/04/2025;18:30;Bayern Munich;Dortmund;2;2;0
29;13/04/2025;15:30;Stuttgart;Werder Bremen;1;2;-1
29;13/04/2025;17:30;Eint Frankfurt;Heidenheim;3;0;3
30;19/04/2025;15:30;RB Leipzig;Holstein Kiel;1;1;0
30;19/04/2025;15:30;Freiburg;Hoffenheim;3;2;1
30;19/04/2025;15:30;Werder Bremen;Bochum;1;0;1
30;19/04/2025;15:30;Heidenheim;Bayern Munich;0;4;-4
30;19/04/2025;15:30;Mainz 05;Wolfsburg;2;2;0
30;19/04/2025;18:30;Union Berlin;Stuttgart;4;4;0
30;20/04/2025;15:30;Augsburg;Eint Frankfurt;0;0;0
30;20/04/2025;17:30;Dortmund;Gladbach;3;2;1
30;20/04/2025;19:30;St. Pauli;Leverkusen;1;1;0
31;25/04/2025;20:30;Stuttgart;Heidenheim;0;1;-1
31;26/04/2025;15:30;Hoffenheim;Dortmund;2;3;-1
31;26/04/2025;15:30;Bayern Munich;Mainz 05;3;0;3
31;26/04/2025;15:30;Leverkusen;Augsburg;2;0;2
31;26/04/2025;15:30;Holstein Kiel;Gladbach;4;3;1
31;26/04/2025;15:30;Wolfsburg;Freiburg;0;1;-1
31;26/04/2025;18:30;Eint Frankfurt;RB Leipzig;4;0;4
31;27/04/2025;15:30;Bochum;Union Berlin;1;1;0
31;27/04/2025;17:30;Werder Bremen;St. Pauli;0;0;0
32;02/05/2025;20:30;Heidenheim;Bochum;0;0;0
32;03/05/2025;15:30;St. Pauli;Stuttgart;0;1;-1
32;03/05/2025;15:30;Gladbach;Hoffenheim;4;4;0
32;03/05/2025;15:30;RB Leipzig;Bayern Munich;3;3;0
32;03/05/2025;15:30;Union Berlin;Werder Bremen;2;2;0
32;03/05/2025;18:30;Dortmund;Wolfsburg;4;0;4
32;04/05/2025;15:30;Augsburg;Holstein Kiel;1;3;-2
32;04/05/2025;17:30;Freiburg;Leverkusen;2;2;0
32;04/05/2025;19:30;Mainz 05;Eint Frankfurt;1;1;0
33;09/05/2025;20:30;Wolfsburg;Hoffenheim;2;2;0
33;10/05/2025;15:30;Bochum;Mainz 05;1;4;-3
33;10/05/2025;15:30;Werder Bremen;RB Leipzig;0;0;0
33;10/05/2025;15:30;Holstein Kiel;Freiburg;1;2;-1
33;10/05/2025;15:30;Union Berlin;Heidenheim;0;3;-3
33;10/05/2025;18:30;Bayern Munich;Gladbach;2;0;2
33;11/05/2025;15:30;Leverkusen;Dortmund;2;4;-2
33;11/05/2025;17:30;Eint Frankfurt;St. Pauli;2;2;0
33;11/05/2025;19:30;Stuttgart;Augsburg;4;0;4
34;17/05/2025;15:30;RB Leipzig;Stuttgart;2;3;-1
34;17/05/2025;15:30;Gladbach;Wolfsburg;0;1;-1
34;17/05/2025;15:30;Heidenheim;Werder Bremen;1;4;-3
34;17/05/2025;15:30;St. Pauli;Bochum;0;2;-2
34;17/05/2025;15:30;Freiburg;Eint Frankfurt;1;3;-2
34;17/05/2025;15:30;Augsburg;Union Berlin;1;2;-1
34;17/05/2025;15:30;Mainz 05;Leverkusen;2;2;0
34;17/05/2025;15:30;Dortmund;Holstein Kiel;3;0;3
34;17/05/2025;15:30;Hoffenheim;Bayern Munich;0;4;-4