WEEK;DATE;TIME;HOME;AWAY;FTHG;FTAG;DIFF
1;22/08/2024;19:10;Al-Taawoun;Al-Fayha;1;0;1
1;22/08/2024;21:00;Al-Nassr;Al-Raed;1;1;0
1;22/08/2024;21:00;Al-Wehda;Al-Riyadh SC;3;3;0
1;23/08/2024;19:10;Damac;Al-Khaleej;0;1;-1
1;23/08/2024;21:00;Al-Qadsiah;Al-Fateh;3;0;3
1;23/08/2024;21:00;Al-Ahli;Al-Orobah;2;0;2
1;24/08/2024;19:10;Al Kholood Saudi Club;Al-Ittihad;0;1;-1
1;24/08/2024;21:00;Al Okhdood SC;Al-Hilal;0;3;-3
1;24/08/2024;21:00;Al-Shabab;Al-Ettifaq;0;1;-1
2;27/08/2024;18:45;Al-Fateh;Al-Ahli;1;0;1
2;27/08/2024;21:00;Al-Raed;Al-Qadsiah;0;1;-1
2;27/08/2024;21:00;Al-Fayha;Al-Nassr;1;4;-3
2;28/08/2024;18:45;Al-Ettifaq;Al Okhdood SC;1;0;1
2;28/08/2024;21:00;Al-Wehda;Al-Orobah;2;1;1
2;28/08/2024;21:00;Al-Hilal;Damac;3;2;1
2;29/08/2024;18:55;Al-Riyadh SC;Al Kholood Saudi Club;3;1;2
2;29/08/2024;21:00;Al-Ittihad;Al-Taawoun;2;1;1
2;29/08/2024;21:00;Al-Khaleej;Al-Shabab;0;1;-1
3;13/09/2024;18:45;Al-Taawoun;Al-Khaleej;2;0;2
3;13/09/2024;18:50;Damac;Al Okhdood SC;3;1;2
3;13/09/2024;21:00;Al-Nassr;Al-Ahli;1;1;0
3;14/09/2024;18:20;Al-Fateh;Al-Ettifaq;1;2;-1
3;14/09/2024;18:45;Al-Fayha;Al-Raed;0;5;-5
3;14/09/2024;21:00;Al-Riyadh SC;Al-Hilal;0;3;-3
3;15/09/2024;18:20;Al-Qadsiah;Al-Shabab;0;1;-1
3;15/09/2024;18:50;Al Kholood Saudi Club;Al-Orobah;3;3;0
3;15/09/2024;21:00;Al-Ittihad;Al-Wehda;7;1;6
4;19/09/2024;18:40;Al Okhdood SC;Al-Qadsiah;0;0;0
4;19/09/2024;18:55;Al-Orobah;Al-Fateh;1;0;1
4;19/09/2024;21:00;Al-Wehda;Al Kholood Saudi Club;0;1;-1
4;20/09/2024;18:15;Al-Khaleej;Al-Fayha;0;0;0
4;20/09/2024;18:55;Al-Ahli;Damac;4;2;2
4;20/09/2024;21:00;Al-Ettifaq;Al-Nassr;0;3;-3
4;21/09/2024;18:30;Al-Shabab;Al-Taawoun;1;0;1
4;21/09/2024;18:35;Al-Raed;Al-Riyadh SC;1;2;-1
4;21/09/2024;21:00;Al-Hilal;Al-Ittihad;3;1;2
5;27/09/2024;18:20;Al-Nassr;Al-Wehda;2;0;2
5;27/09/2024;21:00;Al-Qadsiah;Al-Ahli;1;0;1
5;27/09/2024;21:00;Al-Ittihad;Al-Khaleej;4;1;3
5;28/09/2024;18:10;Al-Fateh;Al Okhdood SC;2;4;-2
5;28/09/2024;18:45;Al-Orobah;Damac;1;0;1
5;28/09/2024;21:00;Al Kholood Saudi Club;Al-Hilal;2;4;-2
5;29/09/2024;18:25;Al-Fayha;Al-Riyadh SC;2;0;2
5;29/09/2024;21:00;Al-Shabab;Al-Raed;2;1;1
5;29/09/2024;21:00;Al-Taawoun;Al-Ettifaq;1;1;0
6;03/10/2024;18:00;Al-Ettifaq;Al-Raed;0;1;-1
6;03/10/2024;21:00;Al Okhdood SC;Al-Ittihad;1;2;-1
6;03/10/2024;21:00;Al-Wehda;Al-Fayha;2;2;0
6;04/10/2024;18:00;Al-Khaleej;Al Kholood Saudi Club;1;0;1
6;04/10/2024;18:15;Al-Riyadh SC;Al-Qadsiah;2;1;1
6;04/10/2024;21:00;Damac;Al-Shabab;1;0;1
6;05/10/2024;18:15;Al-Nassr;Al-Orobah;3;0;3
6;05/10/2024;18:25;Al-Taawoun;Al-Fateh;2;0;2
6;05/10/2024;21:00;Al-Ahli;Al-Hilal;1;2;-1
7;18/10/2024;17:45;Al-Khaleej;Al-Ahli;0;3;-3
7;18/10/2024;18:00;Al-Hilal;Al-Fayha;3;0;3
7;18/10/2024;21:00;Al-Shabab;Al-Nassr;1;2;-1
7;19/10/2024;18:05;Al-Raed;Al-Wehda;2;2;0
7;19/10/2024;18:20;Damac;Al-Taawoun;2;2;0
7;19/10/2024;21:00;Al-Ittihad;Al-Qadsiah;3;1;2
7;20/10/2024;17:45;Al-Fateh;Al Kholood Saudi Club;1;1;0
7;20/10/2024;18:20;Al Okhdood SC;Al-Riyadh SC;0;1;-1
7;20/10/2024;21:00;Al-Ettifaq;Al-Orobah;2;3;-1
8;24/10/2024;18:15;Al-Orobah;Al-Shabab;0;3;-3
8;24/10/2024;21:00;Al-Wehda;Al-Khaleej;1;3;-2
8;24/10/2024;21:00;Al-Riyadh SC;Al-Ittihad;0;1;-1
8;25/10/2024;17:35;Al-Qadsiah;Damac;2;1;1
8;25/10/2024;18:05;Al Kholood Saudi Club;Al-Nassr;3;3;0
8;25/10/2024;21:00;Al-Ahli;Al Okhdood SC;1;1;0
8;26/10/2024;18:00;Al-Fayha;Al-Ettifaq;1;1;0
8;26/10/2024;18:05;Al-Raed;Al-Fateh;2;1;1
8;26/10/2024;21:00;Al-Hilal;Al-Taawoun;2;0;2
9;31/10/2024;17:50;Al-Shabab;Al-Wehda;3;1;2
9;31/10/2024;18:10;Al Okhdood SC;Al-Orobah;4;0;4
9;31/10/2024;21:00;Al-Ittihad;Al-Ahli;1;0;1
9;01/11/2024;17:35;Al-Khaleej;Al-Raed;4;0;4
9;01/11/2024;18:15;Damac;Al-Riyadh SC;2;2;0
9;01/11/2024;21:00;Al-Nassr;Al-Hilal;1;1;0
9;02/11/2024;17:35;Al-Fateh;Al-Fayha;1;1;0
9;02/11/2024;17:55;Al-Taawoun;Al Kholood Saudi Club;1;1;0
9;02/11/2024;21:00;Al-Ettifaq;Al-Qadsiah;0;2;-2
10;07/11/2024;17:30;Al-Qadsiah;Al-Fayha;2;0;2
10;07/11/2024;18:00;Al Kholood Saudi Club;Al-Shabab;0;2;-2
10;07/11/2024;20:00;Al-Orobah;Al-Ittihad;0;2;-2
10;08/11/2024;17:45;Al-Hilal;Al-Ettifaq;3;1;2
10;08/11/2024;18:20;Al-Ahli;Al-Raed;2;0;2
10;08/11/2024;20:00;Al-Riyadh SC;Al-Nassr;0;1;-1
10;09/11/2024;17:30;Al-Fateh;Al-Khaleej;1;2;-1
10;09/11/2024;18:15;Al-Wehda;Damac;2;3;-1
10;09/11/2024;20:00;Al-Taawoun;Al Okhdood SC;1;0;1
11;22/11/2024;17:50;Al-Fayha;Al-Ahli;0;1;-1
11;22/11/2024;18:05;Al Okhdood SC;Al-Shabab;1;1;0
11;22/11/2024;20:00;Al-Nassr;Al-Qadsiah;1;2;-1
11;23/11/2024;16:20;Al-Raed;Al-Orobah;3;1;2
11;23/11/2024;18:15;Al-Wehda;Al-Taawoun;1;0;1
11;23/11/2024;20:00;Al-Khaleej;Al-Hilal;3;2;1
11;24/11/2024;16:40;Damac;Al Kholood Saudi Club;2;1;1
11;24/11/2024;17:40;Al-Riyadh SC;Al-Ettifaq;0;0;0
11;24/11/2024;20:00;Al-Ittihad;Al-Fateh;2;0;2
12;28/11/2024;17:45;Al-Fayha;Al-Orobah;0;1;-1
12;28/11/2024;18:05;Al Okhdood SC;Al Kholood Saudi Club;1;2;-1
12;28/11/2024;20:00;Al-Fateh;Al-Riyadh SC;1;2;-1
12;29/11/2024;17:25;Al-Qadsiah;Al-Khaleej;1;0;1
12;29/11/2024;17:40;Al-Nassr;Damac;2;0;2
12;29/11/2024;20:00;Al-Ahli;Al-Wehda;1;0;1
12;30/11/2024;16:20;Al-Raed;Al-Taawoun;0;1;-1
12;30/11/2024;17:25;Al-Ettifaq;Al-Ittihad;0;4;-4
12;30/11/2024;20:00;Al-Shabab;Al-Hilal;1;2;-1
13;05/12/2024;18:10;Damac;Al-Fayha;2;2;0
13;05/12/2024;18:15;Al-Wehda;Al Okhdood SC;2;3;-1
13;05/12/2024;20:00;Al-Shabab;Al-Fateh;2;2;0
13;06/12/2024;17:50;Al Kholood Saudi Club;Al-Qadsiah;0;3;-3
13;06/12/2024;17:55;Al-Orobah;Al-Riyadh SC;0;1;-1
13;06/12/2024;20:00;Al-Ittihad;Al-Nassr;2;1;1
13;07/12/2024;15:55;Al-Khaleej;Al-Ettifaq;1;2;-1
13;07/12/2024;20:00;Al-Taawoun;Al-Ahli;2;4;-2
13;07/12/2024;20:00;Al-Hilal;Al-Raed;3;2;1
14;09/01/2025;17:45;Al-Fateh;Al-Wehda;1;2;-1
14;09/01/2025;18:00;Al-Riyadh SC;Al-Khaleej;2;2;0
14;09/01/2025;20:00;Al-Nassr;Al Okhdood SC;3;1;2
14;10/01/2025;17:40;Al-Ettifaq;Al Kholood Saudi Club;2;3;-1
14;10/01/2025;18:05;Al-Raed;Damac;0;2;-2
14;10/01/2025;20:00;Al-Ahli;Al-Shabab;3;2;1
14;11/01/2025;16:45;Al-Orobah;Al-Hilal;0;5;-5
14;11/01/2025;17:40;Al-Qadsiah;Al-Taawoun;0;3;-3
14;11/01/2025;20:00;Al-Fayha;Al-Ittihad;1;1;0
15;15/01/2025;18:05;Al-Shabab;Al-Riyadh SC;2;1;1
15;15/01/2025;18:30;Damac;Al-Ettifaq;0;3;-3
15;15/01/2025;20:00;Al Kholood Saudi Club;Al-Ahli;1;0;1
15;16/01/2025;16:55;Al Okhdood SC;Al-Fayha;1;2;-1
15;16/01/2025;18:05;Al-Hilal;Al-Fateh;9;0;9
15;16/01/2025;20:00;Al-Ittihad;Al-Raed;4;1;3
15;17/01/2025;16:15;Al-Khaleej;Al-Orobah;3;0;3
15;17/01/2025;18:40;Al-Wehda;Al-Qadsiah;0;3;-3
15;17/01/2025;20:00;Al-Taawoun;Al-Nassr;1;1;0
16;20/01/2025;18:10;Al-Fayha;Al Kholood Saudi Club;1;0;1
16;20/01/2025;18:15;Al-Raed;Al Okhdood SC;0;2;-2
16;20/01/2025;20:00;Al-Ettifaq;Al-Ahli;1;2;-1
16;21/01/2025;17:50;Al-Khaleej;Al-Nassr;1;3;-2
16;21/01/2025;18:10;Al-Riyadh SC;Al-Taawoun;1;0;1
16;21/01/2025;20:00;Al-Hilal;Al-Wehda;4;1;3
16;22/01/2025;17:00;Al-Orobah;Al-Qadsiah;0;2;-2
16;22/01/2025;17:55;Al-Fateh;Damac;2;1;1
16;22/01/2025;20:00;Al-Ittihad;Al-Shabab;2;1;1
17;25/01/2025;16:50;Al Kholood Saudi Club;Al-Raed;2;1;1
17;25/01/2025;20:00;Al-Wehda;Al-Ettifaq;2;2;0
17;26/01/2025;18:20;Al-Taawoun;Al-Orobah;0;0;0
17;26/01/2025;18:30;Al Okhdood SC;Al-Khaleej;1;2;-1
17;26/01/2025;18:45;Al-Ahli;Al-Riyadh SC;5;0;5
17;26/01/2025;20:00;Al-Nassr;Al-Fateh;3;1;2
17;27/01/2025;17:05;Damac;Al-Ittihad;2;1;1
17;27/01/2025;18:10;Al-Shabab;Al-Fayha;2;1;1
17;27/01/2025;20:00;Al-Qadsiah;Al-Hilal;2;1;1
18;30/01/2025;17:00;Al-Orobah;Al-Ahli;0;2;-2
18;30/01/2025;18:15;Al-Riyadh SC;Al-Wehda;1;0;1
18;30/01/2025;20:00;Al-Raed;Al-Nassr;1;2;-1
18;31/01/2025;16:45;Al-Fayha;Al-Taawoun;0;0;0
18;31/01/2025;18:15;Al-Hilal;Al Okhdood SC;4;0;4
18;31/01/2025;20:00;Al-Ettifaq;Al-Shabab;3;1;2
18;01/02/2025;16:25;Al-Khaleej;Damac;1;1;0
18;01/02/2025;18:00;Al-Fateh;Al-Qadsiah;1;1;0
18;01/02/2025;20:00;Al-Ittihad;Al Kholood Saudi Club;4;3;1
19;06/02/2025;18:05;Al-Qadsiah;Al-Raed;2;0;2
19;06/02/2025;18:20;Al-Shabab;Al-Khaleej;5;1;4
19;06/02/2025;20:00;Al-Taawoun;Al-Ittihad;1;2;-1
19;07/02/2025;16:05;Al-Orobah;Al-Wehda;4;2;2
19;07/02/2025;18:20;Al-Nassr;Al-Fayha;3;0;3
19;07/02/2025;20:00;Al-Ahli;Al-Fateh;2;0;2
19;08/02/2025;16:55;Al Kholood Saudi Club;Al-Riyadh SC;3;2;1
19;08/02/2025;18:40;Al Okhdood SC;Al-Ettifaq;0;2;-2
19;08/02/2025;20:00;Damac;Al-Hilal;2;2;0
20;13/02/2025;17:10;Al Okhdood SC;Damac;0;0;0
20;13/02/2025;18:25;Al-Shabab;Al-Qadsiah;2;3;-1
20;13/02/2025;20:30;Al-Ahli;Al-Nassr;2;3;-1
20;14/02/2025;17:10;Al-Orobah;Al Kholood Saudi Club;2;0;2
20;14/02/2025;18:05;Al-Ettifaq;Al-Fateh;1;2;-1
20;14/02/2025;20:00;Al-Hilal;Al-Riyadh SC;1;1;0
20;15/02/2025;16:35;Al-Khaleej;Al-Taawoun;0;1;-1
20;15/02/2025;18:30;Al-Raed;Al-Fayha;0;2;-2
20;15/02/2025;20:30;Al-Wehda;Al-Ittihad;1;4;-3
21;20/02/2025;18:15;Al-Fateh;Al-Orobah;1;0;1
21;20/02/2025;18:30;Al-Fayha;Al-Khaleej;0;0;0
21;20/02/2025;20:00;Al-Riyadh SC;Al-Raed;1;3;-2
21;21/02/2025;17:20;Damac;Al-Ahli;0;2;-2
21;21/02/2025;18:10;Al-Qadsiah;Al Okhdood SC;2;0;2
21;21/02/2025;20:00;Al-Nassr;Al-Ettifaq;2;3;-1
21;22/02/2025;16:00;Al Kholood Saudi Club;Al-Wehda;1;0;1
21;22/02/2025;17:05;Al-Taawoun;Al-Shabab;2;2;0
21;22/02/2025;21:15;Al-Ittihad;Al-Hilal;4;1;3
22;24/02/2025;17:15;Al Okhdood SC;Al-Fateh;1;3;-2
22;24/02/2025;18:50;Damac;Al-Orobah;1;2;-1
22;25/02/2025;17:10;Al-Raed;Al-Shabab;1;2;-1
22;25/02/2025;18:30;Al-Hilal;Al Kholood Saudi Club;5;1;4
22;25/02/2025;20:00;Al-Wehda;Al-Nassr;0;2;-2
22;25/02/2025;20:30;Al-Ahli;Al-Qadsiah;4;1;3
22;26/02/2025;18:15;Al-Ettifaq;Al-Taawoun;1;0;1
22;26/02/2025;18:30;Al-Riyadh SC;Al-Fayha;0;0;0
22;26/02/2025;20:00;Al-Khaleej;Al-Ittihad;1;1;0
23;28/02/2025;22:00;Al-Orobah;Al-Nassr;0;3;-3
23;28/02/2025;22:00;Al-Hilal;Al-Ahli;2;3;-1
23;28/02/2025;22:00;Al-Shabab;Damac;2;0;2
23;01/03/2025;22:00;Al Kholood Saudi Club;Al-Khaleej;2;1;1
23;01/03/2025;22:00;Al-Fayha;Al-Wehda;0;0;0
23;01/03/2025;22:00;Al-Fateh;Al-Taawoun;1;2;-1
23;02/03/2025;22:00;Al-Raed;Al-Ettifaq;1;1;0
23;02/03/2025;22:00;Al-Qadsiah;Al-Riyadh SC;1;0;1
23;02/03/2025;22:00;Al-Ittihad;Al Okhdood SC;1;1;0
24;06/03/2025;22:00;Al-Qadsiah;Al-Ittihad;1;1;0
24;06/03/2025;22:00;Al Kholood Saudi Club;Al-Fateh;2;1;1
24;06/03/2025;23:00;Al-Wehda;Al-Raed;3;1;2
24;07/03/2025;22:00;Al-Ahli;Al-Khaleej;2;2;0
24;07/03/2025;22:00;Al-Nassr;Al-Shabab;2;2;0
24;07/03/2025;22:00;Al-Fayha;Al-Hilal;0;2;-2
24;08/03/2025;22:00;Al-Riyadh SC;Al Okhdood SC;1;0;1
24;08/03/2025;22:00;Al-Orobah;Al-Ettifaq;1;2;-1
24;08/03/2025;22:00;Al-Taawoun;Damac;3;0;3
25;13/03/2025;22:00;Al-Fateh;Al-Raed;3;1;2
25;13/03/2025;22:00;Al-Ittihad;Al-Riyadh SC;2;1;1
25;13/03/2025;22:00;Al-Shabab;Al-Orobah;6;0;6
25;14/03/2025;22:00;Al-Khaleej;Al-Wehda;0;2;-2
25;14/03/2025;22:00;Damac;Al-Qadsiah;1;0;1
25;14/03/2025;22:00;Al-Nassr;Al Kholood Saudi Club;3;1;2
25;15/03/2025;22:00;Al-Ettifaq;Al-Fayha;0;2;-2
25;15/03/2025;22:00;Al-Taawoun;Al-Hilal;0;2;-2
25;15/03/2025;22:00;Al Okhdood SC;Al-Ahli;2;1;1
26;04/04/2025;17:30;Al Kholood Saudi Club;Al-Taawoun;0;2;-2
26;04/04/2025;17:45;Al-Orobah;Al Okhdood SC;0;1;-1
26;04/04/2025;21:00;Al-Hilal;Al-Nassr;1;3;-2
26;05/04/2025;17:05;Al-Qadsiah;Al-Ettifaq;1;1;0
26;05/04/2025;17:15;Al-Riyadh SC;Damac;0;0;0
26;05/04/2025;21:00;Al-Ahli;Al-Ittihad;2;2;0
26;06/04/2025;17:25;Al-Fayha;Al-Fateh;1;1;0
26;06/04/2025;19:00;Al-Raed;Al-Khaleej;1;2;-1
26;06/04/2025;21:00;Al-Wehda;Al-Shabab;1;3;-2
27;10/04/2025;18:50;Al-Shabab;Al Kholood Saudi Club;2;0;2
27;10/04/2025;19:00;Damac;Al-Wehda;0;1;-1
27;10/04/2025;21:00;Al-Ittihad;Al-Orobah;2;0;2
27;11/04/2025;18:55;Al Okhdood SC;Al-Taawoun;1;1;0
27;11/04/2025;19:00;Al-Raed;Al-Ahli;0;2;-2
27;11/04/2025;21:00;Al-Ettifaq;Al-Hilal;1;1;0
27;12/04/2025;18:35;Al-Khaleej;Al-Fateh;1;5;-4
27;12/04/2025;19:00;Al-Fayha;Al-Qadsiah;2;1;1
27;12/04/2025;21:00;Al-Nassr;Al-Riyadh SC;2;1;1
28;17/04/2025;18:40;Al-Ettifaq;Al-Riyadh SC;1;0;1
28;17/04/2025;18:50;Al-Shabab;Al Okhdood SC;0;0;0
28;17/04/2025;18:50;Al-Hilal;Al-Khaleej;3;0;3
28;17/04/2025;21:00;Al-Fateh;Al-Ittihad;2;0;2
28;18/04/2025;19:05;Al Kholood Saudi Club;Damac;1;3;-2
28;18/04/2025;19:20;Al-Ahli;Al-Fayha;5;0;5
28;18/04/2025;21:00;Al-Qadsiah;Al-Nassr;2;1;1
28;19/04/2025;19:25;Al-Orobah;Al-Raed;0;4;-4
28;19/04/2025;21:00;Al-Taawoun;Al-Wehda;0;2;-2
29;21/04/2025;18:55;Al-Hilal;Al-Shabab;2;2;0
29;21/04/2025;21:00;Al-Ittihad;Al-Ettifaq;3;2;1
29;22/04/2025;19:05;Damac;Al-Nassr;2;3;-1
29;22/04/2025;19:20;Al-Wehda;Al-Ahli;2;3;-1
29;23/04/2025;18:55;Al-Riyadh SC;Al-Fateh;2;2;0
29;23/04/2025;19:10;Al Kholood Saudi Club;Al Okhdood SC;0;1;-1
29;23/04/2025;21:00;Al-Khaleej;Al-Qadsiah;1;1;0
29;24/04/2025;19:30;Al-Orobah;Al-Fayha;2;2;0
29;24/04/2025;21:00;Al-Taawoun;Al-Raed;4;3;1
30;01/05/2025;19:00;Al-Riyadh SC;Al-Orobah;2;4;-2
30;01/05/2025;19:00;Al Okhdood SC;Al-Wehda;1;2;-1
30;01/05/2025;21:00;Al-Fateh;Al-Shabab;3;1;2
30;02/05/2025;18:50;Al-Ettifaq;Al-Khaleej;2;1;1
30;02/05/2025;19:05;Al-Fayha;Damac;2;1;1
30;02/05/2025;21:00;Al-Qadsiah;Al Kholood Saudi Club;4;1;3
30;07/05/2025;19:15;Al-Raed;Al-Hilal;3;5;-2
30;07/05/2025;19:25;Al-Ahli;Al-Taawoun;2;0;2
30;07/05/2025;21:00;Al-Nassr;Al-Ittihad;2;3;-1
31;10/05/2025;19:20;Al Kholood Saudi Club;Al-Ettifaq;1;0;1
31;10/05/2025;19:25;Al-Wehda;Al-Fateh;1;0;1
31;10/05/2025;21:00;Al-Khaleej;Al-Riyadh SC;1;2;-1
31;11/05/2025;19:05;Al-Shabab;Al-Ahli;3;1;2
31;11/05/2025;19:10;Damac;Al-Raed;1;0;1
31;11/05/2025;19:15;Al-Taawoun;Al-Qadsiah;0;1;-1
31;11/05/2025;21:00;Al-Ittihad;Al-Fayha;3;0;3
31;12/05/2025;19:05;Al-Hilal;Al-Orobah;4;0;4
31;12/05/2025;21:00;Al Okhdood SC;Al-Nassr;0;9;-9
32;15/05/2025;18:55;Al-Qadsiah;Al-Wehda;3;1;2
32;15/05/2025;19:05;Al-Riyadh SC;Al-Shabab;1;3;-2
32;15/05/2025;21:00;Al-Raed;Al-Ittihad;1;3;-2
32;16/05/2025;18:55;Al-Fateh;Al-Hilal;3;4;-1
32;16/05/2025;19:40;Al-Orobah;Al-Khaleej;1;2;-1
32;16/05/2025;21:00;Al-Nassr;Al-Taawoun;1;1;0
32;17/05/2025;18:55;Al-Ettifaq;Damac;0;0;0
32;17/05/2025;19:15;Al-Fayha;Al Okhdood SC;2;0;2
32;17/05/2025;21:00;Al-Ahli;Al Kholood Saudi Club;4;1;3
33;20/05/2025;19:00;Al-Qadsiah;Al-Orobah;3;1;2
33;20/05/2025;19:20;Al-Taawoun;Al-Riyadh SC;3;2;1
33;20/05/2025;21:00;Al-Shabab;Al-Ittihad;2;3;-1
33;21/05/2025;19:10;Al-Nassr;Al-Khaleej;2;0;2
33;21/05/2025;19:25;Al Kholood Saudi Club;Al-Fayha;2;0;2
33;21/05/2025;21:00;Al-Wehda;Al-Hilal;1;1;0
33;22/05/2025;19:05;Al Okhdood SC;Al-Raed;1;0;1
33;22/05/2025;19:15;Damac;Al-Fateh;0;1;-1
33;22/05/2025;21:00;Al-Ahli;Al-Ettifaq;1;3;-2
34;26/05/2025;21:00;Al-Fayha;Al-Shabab;0;2;-2
34;26/05/2025;21:00;Al-Raed;Al Kholood Saudi Club;1;2;-1
34;26/05/2025;21:00;Al-Khaleej;Al Okhdood SC;2;3;-1
34;26/05/2025;21:00;Al-Ittihad;Damac;1;0;1
34;26/05/2025;21:00;Al-Hilal;Al-Qadsiah;2;0;2
34;26/05/2025;21:00;Al-Orobah;Al-Taawoun;3;2;1
34;26/05/2025;21:00;Al-Ettifaq;Al-Wehda;2;1;1
34;26/05/2025;21:00;Al-Fateh;Al-Nassr;3;2;1
34;26/05/2025;21:00;Al-Riyadh SC;Al-Ahli;0;1;-1