WEEK;DATE;TIME;HOME;AWAY;FTHG;FTAG;DIFF
1;20/09/2024;19:00;Chelsea;Aston Villa;1;0;1
1;21/09/2024;12:00;Manchester Utd;West Ham;3;0;3
1;21/09/2024;12:30;Brighton;Everton;4;0;4
1;22/09/2024;12:30;Arsenal;Manchester City;2;2;0
1;22/09/2024;14:00;Tottenham;Crystal Palace;4;0;4
1;22/09/2024;14:00;Liverpool;Leicester City;1;1;0
2;27/09/2024;19:30;Crystal Palace;Chelsea;0;7;-7
2;29/09/2024;12:30;Manchester City;Brighton;1;0;1
2;29/09/2024;14:00;Everton;Manchester Utd;0;1;-1
2;29/09/2024;15:00;West Ham;Liverpool;1;1;0
2;29/09/2024;15:00;Leicester City;Arsenal;0;1;-1
2;29/09/2024;16:30;Aston Villa;Tottenham;2;2;0
3;05/10/2024;12:30;Brighton;Aston Villa;4;2;2
3;06/10/2024;13:00;Manchester City;West Ham;2;0;2
3;06/10/2024;14:00;Arsenal;Everton;0;0;0
3;06/10/2024;14:15;Tottenham;Liverpool;2;3;-1
3;06/10/2024;15:00;Leicester City;Crystal Palace;0;2;-2
4;12/10/2024;13:45;Arsenal;Chelsea;1;2;-1
4;13/10/2024;12:30;Manchester Utd;Tottenham;3;0;3
4;13/10/2024;14:00;Crystal Palace;Brighton;0;1;-1
4;13/10/2024;14:00;Aston Villa;Leicester City;0;0;0
4;13/10/2024;14:00;Everton;West Ham;1;1;0
4;13/10/2024;15:00;Liverpool;Manchester City;1;2;-1
5;19/10/2024;12:30;Brighton;Manchester Utd;1;1;0
5;20/10/2024;12:15;Manchester City;Aston Villa;2;1;1
5;20/10/2024;14:00;Liverpool;Crystal Palace;1;1;0
5;20/10/2024;15:00;West Ham;Arsenal;0;2;-2
5;20/10/2024;15:00;Leicester City;Everton;1;0;1
5;20/10/2024;18:45;Chelsea;Tottenham;5;2;3
6;03/11/2024;12:30;Manchester Utd;Arsenal;1;1;0
6;03/11/2024;14:00;Tottenham;West Ham;2;1;1
6;03/11/2024;14:00;Crystal Palace;Manchester City;0;3;-3
6;03/11/2024;14:00;Brighton;Leicester City;1;0;1
6;03/11/2024;16:30;Aston Villa;Liverpool;1;2;-1
6;03/11/2024;18:45;Everton;Chelsea;0;5;-5
7;08/11/2024;19:00;Arsenal;Brighton;5;0;5
7;08/11/2024;19:30;Manchester City;Tottenham;4;0;4
7;10/11/2024;12:30;Liverpool;Chelsea;0;3;-3
7;10/11/2024;14:00;Crystal Palace;Everton;1;1;0
7;10/11/2024;15:00;West Ham;Leicester City;1;0;1
7;10/11/2024;18:45;Manchester Utd;Aston Villa;0;0;0
8;16/11/2024;12:30;Brighton;West Ham;3;2;1
8;16/11/2024;13:45;Tottenham;Arsenal;0;3;-3
8;16/11/2024;17:30;Chelsea;Manchester City;2;0;2
8;17/11/2024;14:00;Aston Villa;Crystal Palace;3;2;1
8;17/11/2024;15:00;Leicester City;Manchester Utd;0;2;-2
8;17/11/2024;15:00;Everton;Liverpool;1;0;1
3;24/11/2024;12:00;Chelsea;Manchester Utd;1;0;1
9;08/12/2024;12:00;Manchester Utd;Liverpool;4;0;4
9;08/12/2024;13:00;Tottenham;Everton;2;1;1
9;08/12/2024;13:00;Manchester City;Leicester City;4;0;4
9;08/12/2024;14:00;Arsenal;Aston Villa;4;0;4
9;08/12/2024;14:00;Chelsea;Brighton;4;2;2
9;08/12/2024;14:30;West Ham;Crystal Palace;5;2;3
10;14/12/2024;12:00;Leicester City;Chelsea;1;1;0
10;14/12/2024;17:30;Brighton;Tottenham;1;1;0
10;15/12/2024;12:30;Everton;Manchester City;2;1;1
10;15/12/2024;14:00;Crystal Palace;Manchester Utd;0;1;-1
10;15/12/2024;14:00;Aston Villa;West Ham;3;1;2
10;15/12/2024;14:30;Liverpool;Arsenal;0;1;-1
11;17/01/2025;19:00;Liverpool;Brighton;2;1;1
11;18/01/2025;17:30;Everton;Aston Villa;1;1;0
11;19/01/2025;12:30;Tottenham;Leicester City;1;0;1
11;19/01/2025;14:00;Arsenal;Crystal Palace;5;0;5
11;19/01/2025;15:00;West Ham;Chelsea;0;5;-5
11;19/01/2025;18:45;Manchester City;Manchester Utd;2;4;-2
12;25/01/2025;12:00;Aston Villa;Manchester City;2;4;-2
12;26/01/2025;12:30;Chelsea;Arsenal;1;0;1
12;26/01/2025;14:00;Crystal Palace;Tottenham;2;3;-1
12;26/01/2025;15:00;West Ham;Everton;2;0;2
12;26/01/2025;15:00;Leicester City;Liverpool;2;1;1
12;26/01/2025;18:45;Manchester Utd;Brighton;3;0;3
13;02/02/2025;12:00;Manchester City;Arsenal;3;4;-1
13;02/02/2025;14:00;Brighton;Crystal Palace;1;1;0
13;02/02/2025;14:00;Liverpool;West Ham;1;0;1
13;02/02/2025;14:00;Everton;Leicester City;4;1;3
13;02/02/2025;14:30;Aston Villa;Chelsea;0;1;-1
13;02/02/2025;18:45;Tottenham;Manchester Utd;0;1;-1
14;16/02/2025;12:00;Manchester Utd;Crystal Palace;3;1;2
14;16/02/2025;12:30;Arsenal;Tottenham;5;0;5
14;16/02/2025;14:00;Chelsea;Everton;2;1;1
14;16/02/2025;15:00;Leicester City;Aston Villa;3;0;3
14;16/02/2025;15:00;West Ham;Brighton;3;1;2
14;16/02/2025;18:45;Manchester City;Liverpool;4;0;4
15;02/03/2025;12:30;Manchester Utd;Leicester City;2;0;2
15;02/03/2025;14:00;Crystal Palace;Liverpool;0;1;-1
15;02/03/2025;14:00;Tottenham;Manchester City;1;2;-1
15;02/03/2025;14:00;Aston Villa;Everton;0;2;-2
15;02/03/2025;15:00;Brighton;Chelsea;2;2;0
15;02/03/2025;17:30;Arsenal;West Ham;4;3;1
16;05/03/2025;19:00;West Ham;Manchester City;1;1;0
16;05/03/2025;19:30;Chelsea;Leicester City;3;1;2
16;14/03/2025;19:00;Everton;Arsenal;1;3;-2
16;14/03/2025;19:15;Liverpool;Manchester Utd;3;1;2
16;16/03/2025;14:00;Crystal Palace;Aston Villa;3;1;2
16;16/03/2025;15:00;Tottenham;Brighton;0;1;-1
17;22/03/2025;14:00;Everton;Crystal Palace;3;0;3
17;22/03/2025;17:30;Arsenal;Liverpool;4;0;4
17;23/03/2025;12:00;West Ham;Tottenham;2;0;2
17;23/03/2025;14:30;Manchester City;Chelsea;1;2;-1
17;23/03/2025;15:00;Leicester City;Brighton;3;2;1
17;23/03/2025;16:30;Aston Villa;Manchester Utd;0;4;-4
18;30/03/2025;12:00;Manchester Utd;Everton;2;0;2
18;30/03/2025;14:00;Leicester City;Tottenham;1;1;0
18;30/03/2025;14:00;Crystal Palace;Arsenal;0;4;-4
18;30/03/2025;14:00;Brighton;Manchester City;1;2;-1
18;30/03/2025;14:00;Liverpool;Aston Villa;1;2;-1
18;30/03/2025;16:30;Chelsea;West Ham;2;2;0
19;15/04/2025;19:30;Arsenal;Leicester City;5;1;4
19;19/04/2025;12:00;West Ham;Manchester Utd;0;0;0
19;19/04/2025;12:30;Brighton;Liverpool;1;2;-1
19;20/04/2025;13:00;Manchester City;Everton;1;1;0
19;20/04/2025;14:00;Tottenham;Aston Villa;2;3;-1
19;23/04/2025;19:15;Chelsea;Crystal Palace;4;0;4
20;27/04/2025;12:00;Liverpool;Tottenham;2;2;0
20;27/04/2025;12:30;Crystal Palace;West Ham;1;7;-6
20;27/04/2025;14:00;Everton;Brighton;2;3;-1
20;27/04/2025;15:00;Leicester City;Manchester City;0;1;-1
20;30/04/2025;18:00;Aston Villa;Arsenal;5;2;3
20;30/04/2025;20:15;Manchester Utd;Chelsea;0;1;-1
21;04/05/2025;12:00;Liverpool;Everton;0;2;-2
21;04/05/2025;12:00;Manchester Utd;Manchester City;2;2;0
21;04/05/2025;14:00;Crystal Palace;Leicester City;2;2;0
21;04/05/2025;14:15;Tottenham;Chelsea;0;1;-1
21;04/05/2025;15:00;West Ham;Aston Villa;2;3;-1
21;05/05/2025;16:00;Brighton;Arsenal;4;2;2
22;10/05/2025;12:30;Manchester City;Crystal Palace;5;2;3
22;10/05/2025;12:30;Arsenal;Manchester Utd;4;3;1
22;10/05/2025;12:30;Chelsea;Liverpool;1;0;1
22;10/05/2025;12:30;Aston Villa;Brighton;3;1;2
22;10/05/2025;12:30;Everton;Tottenham;1;1;0
22;10/05/2025;12:30;Leicester City;West Ham;4;2;2