WEEK;DATE;TIME;HOME;AWAY;FTHG;FTAG;DIFF
1;09/08/2024;19:00;Basel;Young Boys;2;1;1
1;10/08/2024;16:00;FC Zürich;Thun Berner-Oberland;5;1;4
1;10/08/2024;16:00;St. Gallen-Staad;Servette;1;0;1
1;10/08/2024;18:00;Grasshopper;FC Aarau;1;1;0
1;11/08/2024;14:00;FC Luzern;FC Rapperswil-Jona;0;1;-1
2;17/08/2024;16:00;Young Boys;St. Gallen-Staad;0;0;0
2;17/08/2024;16:30;FC Aarau;Basel;2;1;1
2;17/08/2024;18:00;FC Rapperswil-Jona;Servette;0;2;-2
2;17/08/2024;18:00;Thun Berner-Oberland;Grasshopper;1;8;-7
2;17/08/2024;19:00;FC Luzern;FC Zürich;1;2;-1
3;24/08/2024;16:00;FC Zürich;FC Rapperswil-Jona;3;0;3
3;24/08/2024;17:30;St. Gallen-Staad;FC Aarau;5;0;5
3;24/08/2024;18:00;Servette;Young Boys;3;0;3
3;24/08/2024;19:00;Grasshopper;FC Luzern;4;3;1
3;24/08/2024;19:30;Thun Berner-Oberland;Basel;0;3;-3
4;31/08/2024;15:00;Servette;FC Aarau;2;0;2
4;31/08/2024;16:00;FC Zürich;Grasshopper;0;0;0
4;31/08/2024;17:00;Thun Berner-Oberland;St. Gallen-Staad;0;3;-3
4;31/08/2024;19:00;FC Rapperswil-Jona;Young Boys;0;4;-4
4;31/08/2024;19:00;FC Luzern;Basel;1;6;-5
5;13/09/2024;19:00;Basel;FC Zürich;1;2;-1
5;14/09/2024;15:00;Servette;Thun Berner-Oberland;2;0;2
5;14/09/2024;16:00;Young Boys;FC Aarau;2;0;2
5;14/09/2024;17:00;St. Gallen-Staad;FC Luzern;0;1;-1
5;14/09/2024;18:00;Grasshopper;FC Rapperswil-Jona;3;0;3
6;21/09/2024;16:00;FC Zürich;St. Gallen-Staad;0;2;-2
6;21/09/2024;17:00;Thun Berner-Oberland;Young Boys;1;7;-6
6;21/09/2024;18:00;FC Rapperswil-Jona;FC Aarau;0;1;-1
6;21/09/2024;20:00;FC Luzern;Servette;0;2;-2
6;22/09/2024;16:00;Grasshopper;Basel;2;6;-4
7;28/09/2024;16:30;FC Aarau;Thun Berner-Oberland;3;1;2
7;29/09/2024;13:30;Servette;FC Zürich;1;2;-1
7;29/09/2024;14:00;Young Boys;FC Luzern;5;1;4
7;29/09/2024;14:00;St. Gallen-Staad;Grasshopper;1;0;1
8;12/10/2024;16:00;FC Zürich;Young Boys;1;4;-3
8;12/10/2024;18:00;Basel;St. Gallen-Staad;2;1;1
8;12/10/2024;18:00;Grasshopper;Servette;0;1;-1
8;12/10/2024;19:00;FC Luzern;FC Aarau;1;1;0
8;12/10/2024;19:00;FC Rapperswil-Jona;Thun Berner-Oberland;2;2;0
9;19/10/2024;14:30;St. Gallen-Staad;FC Rapperswil-Jona;4;0;4
9;19/10/2024;15:00;Servette;Basel;1;2;-1
9;19/10/2024;16:30;FC Aarau;FC Zürich;2;1;1
9;19/10/2024;18:00;Thun Berner-Oberland;FC Luzern;1;1;0
9;19/10/2024;20:00;Grasshopper;Young Boys;0;3;-3
10;02/11/2024;16:00;Servette;St. Gallen-Staad;2;0;2
10;02/11/2024;16:30;Young Boys;Basel;1;1;0
10;02/11/2024;16:30;FC Aarau;Grasshopper;1;3;-2
10;02/11/2024;18:00;FC Rapperswil-Jona;FC Luzern;0;3;-3
10;02/11/2024;18:00;Thun Berner-Oberland;FC Zürich;0;3;-3
7;13/11/2024;20:00;FC Rapperswil-Jona;Basel;0;3;-3
11;16/11/2024;16:00;FC Zürich;FC Luzern;3;2;1
11;16/11/2024;16:00;Servette;FC Rapperswil-Jona;5;0;5
11;16/11/2024;18:00;Grasshopper;Thun Berner-Oberland;2;1;1
11;17/11/2024;13:00;St. Gallen-Staad;Young Boys;2;2;0
11;17/11/2024;16:00;Basel;FC Aarau;2;0;2
12;23/11/2024;18:00;Young Boys;Servette;0;4;-4
12;03/12/2024;20:00;FC Rapperswil-Jona;FC Zürich;1;3;-2
13;07/12/2024;16:00;St. Gallen-Staad;Thun Berner-Oberland;4;0;4
13;07/12/2024;16:00;Young Boys;FC Rapperswil-Jona;3;0;3
13;07/12/2024;16:30;FC Aarau;Servette;1;2;-1
13;07/12/2024;18:00;Basel;FC Luzern;3;0;3
13;08/12/2024;14:00;Grasshopper;FC Zürich;1;1;0
12;02/02/2025;14:00;FC Luzern;Grasshopper;0;6;-6
12;02/02/2025;14:30;FC Aarau;St. Gallen-Staad;2;1;1
12;02/02/2025;16:00;Basel;Thun Berner-Oberland;5;0;5
14;08/02/2025;16:00;FC Zürich;Basel;1;0;1
14;08/02/2025;16:30;FC Aarau;Young Boys;0;2;-2
14;08/02/2025;18:00;FC Rapperswil-Jona;Grasshopper;0;6;-6
14;08/02/2025;19:00;Thun Berner-Oberland;Servette;0;3;-3
14;09/02/2025;16:30;FC Luzern;St. Gallen-Staad;1;1;0
15;01/03/2025;15:30;Basel;Grasshopper;2;1;1
15;01/03/2025;16:00;Servette;FC Luzern;1;1;0
15;01/03/2025;16:30;FC Aarau;FC Rapperswil-Jona;3;1;2
15;01/03/2025;16:30;Young Boys;Thun Berner-Oberland;6;2;4
15;02/03/2025;14:00;St. Gallen-Staad;FC Zürich;1;0;1
16;08/03/2025;15:30;Basel;FC Rapperswil-Jona;2;0;2
16;08/03/2025;16:00;FC Luzern;Young Boys;0;1;-1
16;08/03/2025;20:00;Thun Berner-Oberland;FC Aarau;1;3;-2
16;09/03/2025;14:00;Grasshopper;St. Gallen-Staad;0;0;0
16;09/03/2025;16:30;FC Zürich;Servette;0;4;-4
17;15/03/2025;16:00;Young Boys;FC Zürich;4;1;3
17;15/03/2025;16:30;FC Aarau;FC Luzern;4;1;3
17;15/03/2025;18:00;Thun Berner-Oberland;FC Rapperswil-Jona;1;0;1
17;16/03/2025;16:00;Servette;Grasshopper;2;3;-1
17;16/03/2025;18:00;St. Gallen-Staad;Basel;1;1;0
18;22/03/2025;17:00;FC Luzern;Thun Berner-Oberland;1;4;-3
18;22/03/2025;17:00;FC Rapperswil-Jona;St. Gallen-Staad;1;6;-5
18;22/03/2025;17:00;Basel;Servette;0;0;0
18;22/03/2025;17:00;Young Boys;Grasshopper;1;0;1
18;22/03/2025;17:00;FC Zürich;FC Aarau;1;0;1
1;12/04/2025;17:00;FC Rapperswil-Jona;FC Yverdon;1;1;0
1;12/04/2025;20:00;Thun Berner-Oberland;FC Schlieren;3;1;2
2;19/04/2025;17:00;FC Schlieren;FC Yverdon;0;2;-2
2;19/04/2025;18:00;Thun Berner-Oberland;FC Rapperswil-Jona;1;1;0
3;26/04/2025;17:00;FC Rapperswil-Jona;FC Schlieren;0;0;0
3;26/04/2025;19:00;FC Yverdon;Thun Berner-Oberland;2;4;-2
4;03/05/2025;17:00;FC Schlieren;Thun Berner-Oberland;0;2;-2
4;03/05/2025;19:00;FC Yverdon;FC Rapperswil-Jona;1;1;0
5;10/05/2025;19:00;FC Rapperswil-Jona;Thun Berner-Oberland;1;1;0
5;11/05/2025;15:00;FC Yverdon;FC Schlieren;1;2;-1
6;17/05/2025;17:00;Thun Berner-Oberland;FC Yverdon;2;2;0
6;17/05/2025;17:00;FC Schlieren;FC Rapperswil-Jona;2;2;0